+---------+
|   W     |
|         |
|   M     |
+---------+